  ██      ██      ██                  ██  ██              ██      ██      ██  ████
  ██  ██  ██  ██  ██  ██████  ██████  ██  ██  ██  ██████  ██  ██  ██  ██  ██  ████
      ██      ██      ██  ██  ██      ██      ██      ██      ██      ██  ██  ████
  ████░░████████████████  ██  ██  ██████████████████  ██████████████████  ██  ████
      ██          ██      ██  ██                  ██  ██              ██      ██░░
████  ██  ██████  ██████  ██  ██████████████████  ██  ██████████████  ██████  ████
          ██  ██          ██  ██          ██      ██  ██      ██          ██  ████
  ██████████  ██  ██████████  ██  ██████  ██  ██████  ██  ██  ██  ██████████  ████
  ██      ██      ██          ██  ██  ██  ██  ██      ██  ██  ██      ██      ██░░
████  ██  ██████████  ██████████  ██  ██  ██  ██  ██████  ██  ██████  ██  ████░░██
      ██  ██          ██          ██      ██  ██  ██      ██      ██          ████
  ██████  ██  ██████████  ██  ██████  ██████  ██  ██  ██████████  ██  ████████░░██
      ██  ██      ██      ██  ██          ██  ██  ██  ██      ██  ██  ██      ████
  ██  ██  ██  ██  ██████████  ██████████  ██  ██  ██  ██████  ██  ██████  ██  ████
  ██  ██  ██  ██          ██      ██      ██  ██  ██  ██      ██          ██  ████
  ██  ██  ██████████████  ██  ██  ██  ██████  ██  ██  ██  ██████████████████  ████
  ██  ██                  ██  ██  ██  ██          ██  ██  ██      ██          ██░░
████  ██████████████████████  ██  ██████  ██████████  ██  ██  ██  ██  ████████░░██
      ██                      ██          ██      ██  ██      ██  ██          ████
  ████████████████████████████░░████████████  ██  ██  ██  ██████  ██████████  ████
              ██              ██      ██SS    ██      ██  ██  ██          ██  ████
  ██████████  ██  ██████████  ██  ██  ██████████████████  ██  ██████████  ██  ████
      ██      ██          ██      ██              ██      ██          ██      ██░░
████  ██  ██  ██████████  ██████████████████████  ██  ██████████████  ████████░░██
      ██  ██  ██          ██              ██      ██  ██              ██      ████
  ██████  ██  ██  ██████████  ██████████  ██  ██████  ██  ██████████  ██  ██  ████
  ██      ██  ██      ██  ██          ██  ██  ██      ██          ██      ██  ██░░
████  ██████  ██████  ██  ██  ██████  ██  ██  ██  ██████  ██████  ██  ████████░░██
      ██      ██  ██  ██  ██      ██  ██  ██      ██          ██  ██  ██      ████
  ██████  ██████  ██  ██  ██████  ██  ██████████████████████  ██  ██████  ██  ████
  ██  ██  ██      ██  ██  ██      ██                      ██  ██          ██  ██░░
  ██  ██  ██  ██  ██  ██  ██  ██████████  ██████████  ██  ██████  ██████████  ████
  ██  ██      ██  ██  ██      ██      ██      ██      ██      ██          ██  ████
  ██  ██████████  ██  ██████████  ██  ██████  ██  ██████████  ██████  ██████  ████
  ██  ██          ██  ██          ██  ██      ██  ██      ██  ██OO    ██      ████
  ██  ██  ██████████  ██  ██████████  ██████████  ██  ██  ██  ██████████  ██  ████
  ██          ██      ██  ██  ██      ██      ██      ██  ██          ██  ██  ████
  ██████████████  ██████  ██  ██  ██████  ██  ██████████  ██████████  ██  ██  ████
                          ██              ██              ██              ██  ██░░
██████████████████████████░░██████████████░░██████████████░░██████████████░░██░░░░
░░░░░░░░░░░░░░░░░░░░░░░░░░░░░░░░░░░░░░░░░░░░░░░░░░░░░░░░░░░░░░░░░░░░░░░░░░░░░░░░░░
